#############
#     #     #
#     #     #
#S          #
#     #     #
#     #     #
## ####     #
#     ### ###
#     #     #
#     #T    #
#           #
#     #     #
#############