#############
#     #     #
#     #     #
#S          #
#     #     #
#     #     #
## ####     #
# ... ### ###
# ... #     #
# ... #T    #
# ...       #
#     #     #
#############