###############
# .... #      #
# .... #      #
#S....        #
# .... #      #
# .... #      #
#      #  T   #
###############