###############
#      #      #
#      #      #
#S            #
#      #      #
#      #      #
#      #  G   #
###############