###############
# .... #      #
# .... #      #
#S.... #      #
# .... #      #
# .... #      #
#         T   #
###############