###############
#      #      #
#      #      #
#S            #
#      #      #
#      #      #
#      #  T   #
###############